%%%%%%%%%%%%%%%%%%%%%%%%%%%%%
%                           %
%                           %
%                           %
%                           %
%                           %
%                           %
%                           %
%                           %
%                           %
%                           %
%                           %
%                           %
%                           %
%                           %
%                           %
%                           %
%                           %
%                           %
%                           %
%                           %
%                           %
%                           %
%                           %
%                           %
%                           %
%                           %
%             P             %
%%%%%%%%%%%%%%%%%%%%%%%%%%%%%
