%%%%%%%%%%%%%%%%%%%%%%%%%%%%%
%             P             %
%                           %
%                           %
%                           %
%                           %
%                           %
%                           %
%                           %
%                           %
%                           %
%                           %
%                           %
%                           %
%                           %
%                           %
%                           %
%                           %
%                           %
%                           %
%                           %
%                           %
%                           %
%                           %
%                           %
%                           %
%                           %
%                           %
%%%%%%%%%%%%%%%%%%%%%%%%%%%%%
