%%%%%%%%%%%%%%%%%%%%%%%%%%%%%
%                           %
%                           %
%                           %
%                           %
%                           %
%                           %
%                           %
%                           %
%                           %
%                           %
%                           %
%                           %
%P                          %
%                           %
%                           %
%                           %
%                           %
%                           %
%                           %
%                           %
%                           %
%                           %
%                           %
%                           %
%                           %
%                           %
%                           %
%%%%%%%%%%%%%%%%%%%%%%%%%%%%%
