%%%%%%%%%%%%%%%%%%%%%%%%%%%%%
%                           %
%                           %
%                           %
%                           %
%                           %
%                           %
%                           %
%                           %
%                           %
%                           %
%                           %
%                           %
%                           %
%             P             %
%                           %
%                           %
%                           %
%                           %
%                           %
%                           %
%                           %
%                           %
%                           %
%                           %
%                           %
%                           %
%                           %
%%%%%%%%%%%%%%%%%%%%%%%%%%%%%
