%%%%%%%%%%%%%%%%%%%%%%%%%%%%%
%                           %
%                           %
%                           %
%                           %
%                           %
%                           %
%                           %
%                           %
%                           %
%                           %
%                           %
%                           %
%                          P%
%                           %
%                           %
%                           %
%                           %
%                           %
%                           %
%                           %
%                           %
%                           %
%                           %
%                           %
%                           %
%                           %
%                           %
%%%%%%%%%%%%%%%%%%%%%%%%%%%%%
